OOOOXOOOOOOOOXOOOO
OXXOXOXXXXXXOXOXXO
OXOOOOOOOOOOOOOOXO
OXOXXOXOXXXXOXXOXO
OOOOOOXOOOOXOOOOOO
OXOXXOXXXXOXOXXOXO
OXOOOOOOOOOOOOOOXO
OXXOXOXXXXXXOXOXXO
OOOOXOOOOOOOOXOOOO